111111111111111111111111111111111111
100000000000000C00000C00000000000111
101001010010000010100100000001010111
1010010P1P00101000100100000001000111
100000000C00C00000000000E0000001C111
111111111111111111111111111111111111