11111111111111111111111111111111111111111111111111
100000000000000C00000C0000000000011111111111111111
10100101001000001010010000000101011111111111111111
1010010P101010100010010000000100011111111111110101
100000000C00C00000000000E0000001C11111101111111111
11111111111111111111111111111111111111111111111111
11111111111111111111111111111111111111111111111111
11111111111111111111111111111111111111111111111111
11111111111111111111111111111111111111111111111111
11111111111111111111111111111111111111111111111111
11111111111111111111111111111111111111111111111111
11111111111111111111111111111111111111111111111111
11111111111111111111111111111111111111111111111111
11111111111111111111111111111111111111111111111111
11111111111111111111111111111111111111111111111111
